                
                
                 
    #####             
    #...#            	
    #o..#          
  ###..o##          
  #..o.o.#              
###.#.##.#######        
#...#.##..#..xx#         
#.o..o....p..xx#        
#####.###.#..xx#            
    #.....######           
    #######	             
                       
                     
                        