                
                
   #####  ####   
   #...####..#   
   #.o....oo.#   
   ##o#.###..#   
    #.#xxx..##   
   ##.#x#x#.#   
   #p..xxx#.#   
   #..###.#o##   
   #.oo....o.#   
   #..####...#   
   ####  #####   
                
                
                
                
				