                
                
                 
                
      #####       
      #...#      
     ##.x.#       
     #.oxo##       
     #.oxo.#       
     #..xo.#       
     ##.x.p#        
      ######         
                     
                
                
                
