                
                
                
                
       #####    
     ###...#    
     #..x#.#    
     #.....#    
    ###o#o##    
    #.....#     
    #...x.#     
    ###.p.#     
      #####     
                  
                
                
                