                
                
                
                
       #####    
     ###...#    
    ##.o.#o##    
    #.o.xxx.#    
    #.#.p.#.#    
    #.xxx.o.#    
    ##o#.o.##    
     #...###    
     #####        
                 
                
                
                
				